0 x*** -> N 1
0 Nx** -> E 2
0 NE*x -> S 3
0 NExS -> W 4

1 *x** -> E 2
1 xE** -> N 1
1 NEx* -> W 4
1 NEWx -> S 3

2 ***x -> S 3
2 *x*S -> E 2
2 xE*S -> N 1
2 NExS -> W 4

3 **x* -> W 4
3 **Wx -> S 3
3 *xWS -> E 2
3 xEWS -> N 1

4 x*** -> N 1
4 N*x* -> W 4
4 N*Wx -> S 3
4 NxWS -> E 0